==== STORE ====
#StoreBuyButtonText	Купить
==== MENU ====
#MenuSaveButton	Сохранить
#MenuLoadButton	Загрузить
#MenuStatsButton	Статистика
#MenuExitButton	Выйти
==== PROFILE ====
#ProfileEnterNamePrompt	ВВЕДИТЕ ИМЯ
#ProfileSaveButtonText	Сохранить
==== STATS ====
#StatMoneyWaste	Всего монет потрачено
#StatMoneyCollected	Всего монет собрано
#StatDamageReceieved	Всего урона получено
#StatKilledEnemyCount	Убитых противников
#StatHealthKitsUsed	Всего использовано аптечек
==== ITEMS ====
#LeatherArmor	Кожаная Броня
#MetallicArmor	Металлическая Броня
#KnifeItem	Нож
#ShieldPlaceholder	Щит (плейсхолдер)
#SwordItem	Меч